wwwwwwwwwwwwwwwwwwwwwwwwwwwwwwwwwwwwwwwwwwwww
wwwwwwwwwwwwwwwwwwwwwwwwwwwwwwwwwwwwwwwwwwwww
wwwwwwwwwwwwwwwwwwwwwwwwwwwwwwwwwwwwwwwwwwwww
wwww w w w w w w w w w w w w w w w w w w wwww
www     n        n        n               www
www                                   c   www
www         c                 wwwwwwwwwwwwwww
www       wwww      1         wwwwwwwwwwwwwww
www      wwwwww                           www
www       wwww                        c   www
www                           wwwwwwwwwwwwwww
www                  1        wwwwwwwwwwwwwww
www                                       www
www                         c             www
www                       wwww            www
www                      wwwwww           www
www                       wwww            www
www                                       www
www                                       www
www                                       www
we                                        www
we                                        www
we                                        www
www                                       www
www                                       www
www                                       www
www                       2               www
www                       w               www
www        1             www     1        www
www                       w               www
www                 w                     www
www      1          www      1            www
www                 w                     www
www           w     2                     www
www     1     www                  1      www
www     2     w                           www
www     w     2                           www
www    www                                www
www     w                                 www
www                                       www
www              w       w                www
wwww w w w w w wwww     wwww w w w w w w wwww
wwwwwwwwwwwwwwwwwwww s wwwwwwwwwwwwwwwwwwwwww
wwwwwwwwwwwwwwwwwwww   wwwwwwwwwwwwwwwwwwwwww
wwwwwwwwwwwwwwwwwwwwwwwwwwwwwwwwwwwwwwwwwwwww
