wwwwwwwwwwwwwwwwwwwwwwwwwwwwwwwwwwwwwwwwwwwww
wwwwwwwwwwwwwwwwwwwweeewwwwwwwwwwwwwwwwwwwwww
wwwwwwwwwwwwwwwwwwww   wwwwwwwwwwwwwwwwwwwwww
www            wwwww   wwwww              www
www             wwww   wwww               www
www              www   www                www
www               ww   ww                 www
www       wwww     w   w       wwww       www
www       wwww                 wwww    n  www
www       wwww       1         wwww       www
www                                       www
www                wwwww                  www
www                wwwww                  www
www                wwwww                  www
www                                       www
www  c                                 n  www
www                                       www
wwwwwwwwwwwwwwwwwwwwwwwwwwwwwwwwww        www
wwwwwwwwwwwwwwwwwwwwwwwwwwwwwwwwww        www
wwwwwwwwwwwwwwwwwwwwwwwwwwwwwwwwww        www
w                                         www
w s                                       www
w                                      n  www
www                                       www
www                                       www
www                                       www
www         1                             www
www           1                           www
www             1                         www
www               1                       www
www                 1                     www
www                   1                   www
www                     1                 www
www                       1               www
www                         1             www
www                           1           www
www                                       www
www                                       www
www                                       www
wwww      2       2       2       2      wwww
wwwww  c  w   c   w   c   w   c   w  c  wwwww
wwwwww   www     www     www     www   wwwwww
wwwwwwwwwwwwwwwwwwwwwwwwwwwwwwwwwwwwwwwwwwwww
wwwwwwwwwwwwwwwwwwwwwwwwwwwwwwwwwwwwwwwwwwwww
wwwwwwwwwwwwwwwwwwwwwwwwwwwwwwwwwwwwwwwwwwwww
