wwwwwwwwwwwwwwwwwwwwwwwwwwwwwwwwwwwwwwwwwwwww
wwwwwwwwwwwwwwwwwwwweeewwwwwwwwwwwwwwwwwwwwww
wwwwwwwwwwwwwwwwwwww   wwwwwwwwwwwwwwwwwwwwww
www  n               n                 n  www
www                  1                    www
www  wwwwwwwwwwwwwwwwwwwwwwwwwwwwwwwwwww  www
www  wwwwwwwwwwwwwwwwwwwwwwwwwwwwwwwwwww  www
www                                       www
www  1               1                 1  www
www                                       www
www                                       www
www                                       www
www                                       www
www                                       www
www                                       www
www                                       www
www                                       www
www                                       www
www                   c                   www
www                                       www
www                                       www
www                                       www
www                   2                   www
www                   w                   www
www                  www                  www
www                 wwwww                 www
www                  www                  www
www                   w                   www
www                  www                  www
www                 wwwww                 www
www                  www                  www
www  c                w                c  www
www                   2                   www
wwwwwwwwwwww                     wwwwwwwwwwww
wwwwwwwwwwwww         1         wwwwwwwwwwwww
wwwwwwwwwwwwww                 wwwwwwwwwwwwww
wwwwwwwwwwwwwww               wwwwwwwwwwwwwww
wwwwwwwwwwwwwwww             wwwwwwwwwwwwwwww
wwwwwwwwwwwwwwwww           wwwwwwwwwwwwwwwww
wwwwwwwwwwwwwwwwww         wwwwwwwwwwwwwwwwww
wwwwwwwwwwwwwwwwwww       wwwwwwwwwwwwwwwwwww
wwwwwwwwwwwwwwwwwwww     wwwwwwwwwwwwwwwwwwww
wwwwwwwwwwwwwwwwwwwww s wwwwwwwwwwwwwwwwwwwww
wwwwwwwwwwwwwwwwwwwww   wwwwwwwwwwwwwwwwwwwww
wwwwwwwwwwwwwwwwwwwwwwwwwwwwwwwwwwwwwwwwwwwww
